{
  "cellSize": 32,
  "spriteScale": 2,
  "ballScale": 2,
  "walkSpeed": 120,
  "playerSpeed": 160,
  "floors": [
    { "key": "map2f", "src": "/assets/map-2f.png", "width": 1152, "height": 704 },
    { "key": "map1f", "src": "/assets/map-1f.png", "width": 1152, "height": 704 }
  ],
  "floorBoundaryRow": 22,
  "collisionMap": [
    "####################################",
    "####################################",
    "############################...$####",
    "############################...$####",
    "###........##.##....................",
    "...........##.......................",
    "..#........##.......................",
    "#..........###......................",
    "#####..######################..#####",
    "#####..######################..#####",
    ".................######.............",
    "....................................",
    "....................................",
    "..........................##########",
    "#####..######...###..###..##########",
    "#####..#######..###+.###+.##........",
    "#####..#######..###..###..##........",
    "...........###......................",
    "............##..###..###.....###+...",
    "..###+.....###..###+.###+.##.###...#",
    "..###.......##..###..###..##.###....",
    "...........###............##.......#",
    "####################################",
    "####################################",
    "##############################..%###",
    "##############################..%###",
    "......*###..........................",
    "......*.............................",
    "......*.............................",
    "......*.............................",
    "*******......###....###.......##....",
    "............#...#..#...#......##....",
    "...........#.....##.....#..........#",
    "..........#..............#....++....",
    ".##..##...#..............#....##.+..",
    ".##..##....#............#.....##.+.#",
    "............#...#..#...#............",
    ".##..##......#.#....#.#.......++....",
    ".##..##.......................##.+..",
    "..............................##.+..",
    "....................................",
    "...................................#",
    ".......................#..#..#..#...",
    "########.###########################"
  ],
  "playerSpawn": { "col": 8, "row": 42 }
}
